8 10
........
........
........
........
...##...
#......#
#......#
........
........
........
