8 9
# .p .p .p .p .p .p #
. .  .  .  .  .  .  .
. .  #  .  .  #  .  .
. .  .  .  .  .  .  .
. .  .  .  .  .  .  .
. .  .  .  .  .  .  .
. .  #  .  .  #  .  .
. .  .  .  .  .  .  .
# .  .  .  .  .  .  #