8 10
.p2 .p3 p4. p1. .p0 .p .p .p
.0  .0  .   .   .   .  .  .
.   .   .   .   .   .  .  .
.   .   .   .   .   .  .  .
.   .   .   #   #   .  .  .
#   .   .   .   .   1. .  #
#   #   .   .   .   .2 .  #
.e  .   .   .   .   4. .  .
.   .   .   .   .   .  .  .
.   .   .   .   .   .  .  .
